{
    "map": [[0, 0, 1, 0, 0, 1, 0, 0, 0, 1, 0, 4],
            [0, 0, 1, 0, 0, 1, 0, 1, 0, 1, 0, 0],
            [0, 0, 1, 0, 0, 1, 0, 1, 0, 1, 0, 0],
            [4, 0, 0, 0, 0, 1, 0, 1, 1, 1, 0, 0],
            [0, 0, 0, 0, 1, 1, 0, 0, 0, 1, 0, 0],
            [1, 1, 0, 0, 0, 0, 0, 0, 0, 1, 1, 0],
            [0, 1, 0, 0, 0, 1, 0, 0, 0, 0, 0, 0],
            [0, 1, 0, 1, 1, 1, 1, 1, 1, 1, 1, 0],
            [0, 1, 0, 1, 1, 1, 0, 0, 0, 0, 0, 0],
            [0, 1, 0, 0, 0, 0, 0, 0, 1, 0, 1, 0],
            [0, 1, 0, 1, 1, 1, 1, 0, 1, 0, 1, 0],
            [0, 0, 0, 0, 0, 0, 0, 0, 1, 0, 0, 0]],
    "SizeX": "12",
    "SizeY": "12"
}