{
    "map": [[0, 0, 1, 0, 0, 1, 4, 0],
            [0, 0, 1, 0, 0, 1, 0, 1],
            [0, 0, 1, 0, 0, 1, 0, 1],
            [4, 0, 0, 0, 0, 1, 0, 1],
            [0, 0, 0, 0, 1, 1, 0, 0],
            [1, 1, 0, 0, 0, 0, 0, 0],
            [0, 1, 0, 0, 0, 1, 0, 0],
            [0, 1, 0, 1, 1, 1, 1, 1]],
    "SizeX": "8",
    "SizeY": "8"
}