{
    "map": [[0, 0, 1, 0, 0, 1, 0, 0, 0, 1, 0, 10],
            [0, 0, 1, 0, 0, 1, 0, 1, 0, 1, 0, 0],
            [0, 0, 1, 0, 0, 1, 0, 1, 0, 1, 0, 0],
            [10, 0, 0, 0, 0, 1, 0, 1, 1, 1, 0, 0],
            [0, 0, 0, 0, 1, 1, 0, 0, 0, 1, 0, 0],
            [1, 1, 0, 0, 0, 0, 0, 0, 0, 1, 1, 0],
            [0, 1, 0, 0, 0, 1, 0, 0, 0, 0, 0, 0],
            [0, 1, 0, 1, 1, 1, 1, 1, 1, 1, 1, 0],
            [0, 1, 0, 1, 1, 1, 0, 0, 0, 0, 0, 0],
            [0, 1, 0, 0, 0, 0, 0, 0, 1, 0, 1, 0],
            [0, 1, 0, 1, 1, 1, 1, 0, 1, 0, 1, 0],
            [0, 0, 0, 0, 0, 0, 0, 0, 1, 0, 0, 3]],
    "SizeX": "12",
    "SizeY": "12"
}